XXXXXXXXXXXXXXXXXXXXXXXXXXXXXXXXXXXXXXXX
X......................................X
X......................................X
X......................................X
X......................................X
X......................................X
X......................................X
X......................................X
X......................................X
X......................................X
X......................................X
X......................................X
X......................................X
X......................................X
XXXXXXXFFFXXXXXXXXXXXXXXXXXXXXXXXXXXXXXX 